****************************************************
*               **      *****  **           ****** *
*          *******     **   *  *******      **  ** *
*        ***** ****        **   *******     **  ** *
*  **                                              *
*****                                              *
*   *    *    *** * ** * *** **** *** * ** * *** ***
*        ***** ****        * *  ******* *   **   * *
*  **                                              *
*   *   *      **        **   ******* *           **
*   *   * **  ***   ** * *** **** *** * ** * *** ***
*   *  *****  **   *****  **      **    ****  **  **
*  **    **                                        *
*        **    **        **   *******     **      **
*****          **              *****               *
****************************************************
