******************************************************************
*                             *                                  *
*    *    *    **********     *     *************************    *
*    *    *    *              *                             *    *
*    *    *********************    *********************    *    *
*    *                             *                   *    *    *
*    ***********************************     ***********    *    *
*    *              *                        *         *    *    *
*    **********     *    *    ***********    *    *    *    ******
*    *              *    *    *         *    *    *    *         *
*    *     **********    *    *****     *    *    *    *    *    *
*    *                   *    *         *    *    *    *    *    *
*    *********************    *     *****    *    *    *    *    *
*                             *              *    *    *    *    *
**************************    ****************    *    ******    *
*              *         *    *                   *    *         *
*    *    *    *    *    *    *    ****************    *****     *
*    *    *    *    *    *    *    *              *              *
*    *    *    *    *    *    *    *     ********************    *
*    *    *         *    *    *    *                        *    *
*    *    ****************    *    *    ***********    *    *    *
*    *                        *    *    *         *    *    *    *
*    **************************    *    *    *    *    *    *    *
*    *         *              *    *    *    *    *    *    *    *
*    *    *    **********     *    *    ******    *    ******    *
*         *                   *    *              *              *
******************************************************************
