*******************************************************************************************
*                    *  *     *     *  *                       *                    *     *
*  *  *  *  *******  *  ****  ****  *  ****  *************  ****  **********  ****  *  ****
*  *  *  *     *        *        *                    *           *     *  *  *     *     *
*  **********  **********  ****  *  *  *******  **********  ****  ****  *  *******  *  ****
*     *           *        *        *        *        *     *  *        *     *  *        *
*  *******  *  ****  *  ****  *  *  ****  *******  *  *******  *  ****  ****  *  *  *******
*  *  *  *  *     *  *     *  *  *  *  *  *        *     *        *        *     *     *  *
****  *  *  *******  *******  *  ****  ****  ****  *  *******  *  *******  ****  *  *  *  *
*     *        *     *  *     *  *        *     *  *  *        *        *  *  *     *     *
*  *  *  *  *  *  ****  **********  ****  *******  *************  *  *  ****  ****  *  *  *
*  *     *  *     *           *  *     *  *     *  *  *     *     *  *  *     *     *  *  *
*  ****************  **********  ****  *  *  ****  *  ****  ****  **********  *  **********
*     *  *  *           *        *  *  *  *  *     *  *  *     *     *                    *
****  *  *  *  *  **********  ****  *  ****  *  ****  *  *  **********  ****  *  ****  *  *
*     *     *  *        *     *           *        *     *        *  *  *  *  *  *     *  *
*  *******  *  *  ****  ****  ****  ****  *  *  ****  **********  *  *  *  *  *************
*        *     *  *     *           *        *     *           *        *     *  *        *
**********  **********  ****  *  *  **********  *************  *  *  ****  ****  *  *  *  *
*     *     *        *        *  *        *  *  *     *     *     *  *        *     *  *  *
****  *  *  *  **********  **********  *  *  ****  ****  *  *  ****************  *  *******
*     *  *     *  *  *        *     *  *  *     *        *  *        *           *  *  *  *
****  ****  ****  *  ****  ****  *******  ****  ****  *  ****  ****  *  *  **********  *  *
*              *        *  *  *                 *  *  *        *  *     *        *  *  *  *
*  *******  *  *  *  ****  *  ****  *******  ****  *******  *  *  ****  *  *  ****  *  *  *
*     *  *  *     *  *     *  *  *     *  *  *  *     *     *  *        *  *              *
****  *  ****  *******  *  *  *  *******  *  *  *  *******  **********  ****  *************
*  *  *  *  *     *  *  *        *              *  *  *           *  *     *        *     *
*  ****  *  ****  *  *******  *  **********  ****  *  *  **********  ****  **********  *  *
*  *  *  *        *  *        *  *  *     *     *     *        *     *                 *  *
*******************************************************************************************
