**************************************************
*                                                *
*                                                *
*                *********                       *
*       **********           *********   *       *
*                    *****       *               *
*  ***********   ** **   *****   *   *****       *
*      *         *   *       *   *       *       *
*      * *****   *   *****   *   *********       *
*      *     *   *   *       *       *   *       *
*      ***   *   *   *   ******  *   *   *       *
*        *   *           *       *   *           *
*        *   *********   *****   *   *****       *
*        *                       *       *       *
*       ******   *   ******  *********   *********
*                         *                      *
*                                                *
**************************************************
